############
#     H    #
#          #
#          #
#          #
#          #
#          #
#          #
#    E     #
##### ######
#          #
#          #
#    E     #
##### ######
#          #
#          #
#    E     #
##### ######