#######################################################################
#                                                                     #
#  #         #  #########  #       #                                  #
#   #       #   #       #  #       #                                  #
#    #     #    #       #  #       #                                  #
#     #   #     #       #  #       #                                  #
#      # #      #       #  #       #                 H                #
#       #       #       #  #       #                                  #
#       #       #       #  #       #                                  #
#       #       #       #  #       #                                  #
#       #       #       #  #       #                                  #
#       #       #########   #######                                   #
#                                                                     #
#  #                 #   #########   # #       #                      #
#   #               #        #       #  #      #                      #
#    #             #         #       #   #     #                      #
#     #     #     #          #       #    #    #                      #
#      #   # #   #           #       #     #   #                      #
#       # #   # #            #       #      #  #                      #
#        #     #         #########   #       # #                      #
#                                                                     #
#                                                                     #
#######################################################################